11111111111111111111111
10010000000000000000001
10000111110010000011101
1P001100000011000000001
10000000E00000000000001
10C00C00001000000000001
10010011100001100000001
10010000000000001100001
11111111111111111111111
