11111111111111111111111
10010000000000000000001
10000111110010000011101
1P0011E0000011000000001
10000000000T00000000001
10C00000000000000000001
10000000000000T00000001
10000000000T00000000001
11111111111111111111111
