11111111111111111111111
10010000T00000000000001
10000111110010000011101
1P0011E0000011000000001
10000000000T00000T00001
10C000T0000000000000001
1000000000000T000000001
10000000000000000000001
11111111111111111111111
