11111111111111111111111
10010000T00000000000001
10000111110010000011101
1P0011E0000011000000001
1000000C00000C0000T0001
10C00T00000000000000001
1000000C00T00T000000001
1000000000000000000T001
11111111111111111111111
