11111111111111111111111
10010000000000000000001
10000111110010000011101
1P0011E0000011000000001
10000000000000000000001
10C000000010000C0000001
10000001000000000000001
10000000000T00000000001
11111111111111111111111
