111111111
10P000001
1EC000001
111111111